LLL.LLL..
LLL.L..LL
.LLLLL..L
LL..L..LL
L...L...L
L...L.L.L
LLLL.L..L
L.LLLL.LL
L.LLL..LL
.LLLLLL..
L.LL..LL.
LLL.LL.LL
LLLL.LLL.
