.L..LLLLLL
LLL...LL.L
LLLLLLLLL.
LLLL.LLL..
LLLLLL....
L.LLL.L..L
.L.LLLL.LL
LLLL.LLL..
LL.LLL.L.L
L.L.LL..LL
LLLLL.....
LL.LLLL.LL
LL.LLLLLLL
LLL.LLLL..
