LLLLL...LLL.LL
..LL.LLLL.LL.L
L..LLLLL.LLLLL
.LL.LLLLL.L.LL
L.LL.L.LLLLLLL
L.LLL.L.LL.L..
.L..LLL.L..LLL
..LLLLLLLL..L.
LLLL.LL..L...L
LLLLLLLLLLLLL.
L.L..L.L....LL
..LLLLLLL.LLLL
L..L.LL...LL.L
