..LLLLL.L
.LL.LLLLL
LL.LLLLL.
LLL.LLLL.
LL.L.LL..
LLLL...LL
L.L.LLLL.
..LLLL.L.
