..LL.LL.LLL..L..
LL.LL..L.L.L.L.L
LLL.LLL.L.LL..LL
LL.LLLLL..LLL..L
LL.L..L.LL.LL.L.
L..LL.LL..L.LL.L
LLLL.L.LL....LL.
LLL...L.LLLL.LL.
..LLLLL.LLL.L.LL
LLLLLLLLL..L..LL
LLLLL....L.L..LL
LLLLLLL.L.LL.LL.
.LL...LLLLLLLLLL
L.LLLLLL..L..LLL
..LLLLL.LLL.L.LL
