LL...LLL.LLLLLL
LL.L.L...LLLLLL
LLL.LL..LLLLLLL
LL.LLLL..LL..LL
L.LLL.LL.LLL..L
LLLLLL.L.L..LL.
....L.L..L.LLLL
L.LLLLLLLLL...L
...L.LLLLL.L.LL
LLL.LL.L..LLL..
.LLLL.L.LL.LLLL
.LLLL.L.LLL.L.L
LLL..LLL.LLLLL.
LL...L.LLL.LLLL
.LLLLLLLLL.L.L.
