.LL.L.LLL.L
.LLLLLLL...
LLLLLLLL..L
L.L..L.LLL.
LL....LL...
LL.LL..LLLL
LLLLL.LLL.L
LLLLLLLLLLL
L..LLL...L.
L.LL.LLLLLL
LL.LL.LLLLL
