L.L..L.L..
...LLL..LL
LLLLL...LL
.L.LLLL...
.LLLLLL.L.
.LL...LLLL
LLLLLLLLLL
L..LL.LLL.
..L.L.L.L.
