LL.LLLL..LL
L...L..LLL.
LL.LLLLLLLL
...LLLLL.L.
L.LLL.LLLLL
LL.LLLLLLL.
LL.LLLLL..L
.LL.LL...L.
LL.LLLLLL.L
.L.LLLLL.LL
L.L.LL.L.L.
L.LL.LLLLL.
LLL.LLL.LLL
LLLLLLLLLLL
L.L..L.L.LL
LLLLLL.L..L
