L.LLLLLLL...L.L
.L.LLL.LL..L..L
LL.L.L..LLLL.LL
..LLLL.L.LL.L.L
.L.LLL.LLLLLLL.
LLLL.L.LLLLLLL.
.L...LL.LL.LLLL
L.LLLLLLLLLL.LL
...L.L.LLLLL..L
L.LLLLLLLL.LLLL
LL...LLLL..LLL.
LLLLLL...LLL..L
LL.L...L..L.LLL
LL..LL.L.L..LL.
.LLL.LLLL.LLLL.
LLL.L.LLLL.LL..
