LLLLLL.LLLL.L
.LL.L..LL..L.
LLL...LLLLLLL
.LLLLLLL...L.
LLL.L.LLLL.L.
LLL..LLLLLLLL
.LLLL...LLLLL
LLLLLLLL.LLLL
L.L.LL.L.LLLL
LL...L..LLLL.
..L..LLLLL.LL
L.L..LLL..L..
LLLLLLLL.LLLL
.LL.L.LLLLLLL
L.LLLLL.LL.LL
