L...LLLL.L
L.L.LLLL.L
LL.LLL..L.
LLL.L..LL.
L.LL..L.LL
LL.LLLL.LL
.LL.LL..LL
L.LLLLLL.L
.LLLLLLLLL
L.LLLLL.LL
