.LL..L.LLLL.L
LL.L..L..LLLL
LL.LLLLLL..LL
..L.L...LLLLL
L.L.LLLLLLLLL
LL.L..L.LLLLL
LLLL.LLL.L.LL
LLLL.LLLL.L.L
