L..LLLL.LL...LL.
L.LLLLLLLL.LLL..
.LL....L.LL.LL.L
LLLLL.LLL.LL.LL.
.L..LLL.L.LLL..L
LLLL..LLL..LLLL.
LLL.LL.LLLLLL..L
LL.LL.L.LL.LL.LL
