L.LLLL..L
LL...L.L.
..L.LLLLL
LLL..LLLL
..LL.LLLL
LL...LLLL
L..L..LLL
LL.LLLL.L
L.LL.LLLL
