L..LLLLLL..LLLL
L.L.LLL.LLLLLLL
L.LLL.LLLLLL.L.
..L.L.LL.LLLL..
.LLLLL.LLLLLL..
.LLLLLLLLLLL.LL
LLL.LLLLL.L.LLL
LLL..LL..L..LLL
LL.LLLLLLLLLL.L
