.LLLLLL..
LLLLL.LLL
LLL.LLLLL
..LL.L.LL
.L..LL.L.
..LLLLL.L
.LLLLLLLL
.LL..L...
..LLLLL.L
.LL.LLL.L
L.LLLLLLL
..LLLLL.L
L...LLL.L
LL.LLL.LL
.LLL..L..
LLL...L.L
