..L...LL
.LL.LLLL
LL....L.
.LLLL.LL
LLLLLL.L
L.L.LLLL
LLLL.L..
LLLLLL.L
LLLLL.LL
LLL.LLLL
